Show the drive letters before the name => rbtnShowDriveLetterBeforeName,lstItemExplorer,tabControlExplorer,tabDriveLetterDisplay
Show the drive letters after the name => rbtnShowDriveLetterAfterName,lstItemExplorer,tabControlExplorer,tabDriveLetterDisplay
Don't Show the drive letters Do not => rbtnHideDriveLetter,lstItemExplorer,tabControlExplorer,tabDriveLetterDisplay
Always Show Menubar => chkShowMenuBar,lstItemExplorer,tabControlExplorer,tabAdvanced
Show hidden files and folders => chkShowHiddenFilesFolders,lstItemExplorer,tabControlExplorer,tabAdvanced
Hide extensions for known file types => chkHideExtension,lstItemExplorer,tabControlExplorer,tabAdvanced
Use checkboxes to select items => chkSelectItems,lstItemExplorer,tabControlExplorer,tabAdvanced
Restore previously opened folders at login => chkRestoreFoldersAtLogin,lstItemExplorer,tabControlExplorer,tabAdvanced
Show protected operating system files => chkShowOSfiles,lstItemExplorer,tabControlExplorer,tabAdvanced
Display compressed and encrypted NTFS files in colour => chkShowNtfsInColor,lstItemExplorer,tabControlExplorer,tabAdvanced
Disable expand to current folder in left navigation pane => chkAutoExpand,lstItemExplorer,tabControlExplorer,tabAdvanced
Disable you have new apps that can open this type of file notification => chkNoNewAppAlert,lstItemExplorer,tabControlExplorer,tabAdvanced
Hide Security in Folders Files Shortcuts and Drives => chkHideSecurity,lstItemExplorer,tabControlExplorer,tabProperties
Hide Customize in Folders Files Shortcuts and Drives => chkShowHideCustomize,lstItemExplorer,tabControlExplorer,tabProperties
Show Libraries in Navigation Pane => rbtnShowLibraries,lstItemExplorer,tabControlExplorer,tabLibrary
Hide Libraries in Navigation Pane => rbtnHideLibraries,lstItemExplorer,tabControlExplorer,tabLibrary
Show my desktop background on Start => chkDesktopBkgOnStart,lstItemExplorer,tabControlExplorer,tabStartScreen
When I sign in or close all apps on a screen go to the desktop instead of Start => chkNavigateToDesktopOnClose,lstItemExplorer,tabControlExplorer,tabStartScreen
Show Start on the display I am I'm using when I press the Windows logo key => chkStartOnDisplay,lstItemExplorer,tabControlExplorer,tabStartScreen
Show the Apps view automatically when I go to Start => chkAppsViewOnStart,lstItemExplorer,tabControlExplorer,tabStartScreen
Search everywhere instead of just my apps when I search from the Apps view => chkSearchEverywhere,lstItemExplorer,tabControlExplorer,tabStartScreen
List desktop apps first in the Apps view when it's it is sorted by category => chkListDesktopApps,lstItemExplorer,tabControlExplorer,tabStartScreen
When I point to the upper right corner show the charms => chkCharmsTR,lstItemExplorer,tabControlExplorer,tabNavigation
When I click the upper left corner switch between my recent apps => chkAppsTL,lstItemExplorer,tabControlExplorer,tabNavigation
Replace Command Prompt with Windows PowerShell in the menu when I right click the lower left corner or press Windows key X key+X => chkReplaceCmdPromptWithPs,lstItemExplorer,tabControlExplorer,tabNavigation
Add Recycle Bin to My Computer => chkAddRecycleBinToMyComputer,lstItemExplorer,tabControlExplorer,tabEtc
Add Registry Editor Regedit to Control Panel => chkAddRegeditToControlPanel,lstItemExplorer,tabControlExplorer,tabEtc
Kill applications immediately and shutdown straightaway => rbtnShutdownImmediately,lstItemSystem,tabControlSystem,tabShutdwnConfig
Wait for applications to exit for milliseconds => rbtnShutdownAfterWaiting,lstItemSystem,tabControlSystem,tabShutdwnConfig
Manufacturer => lblManufacturer,lstItemSystem,tabControlSystem,tabEditInfo
Model => lblModel,lstItemSystem,tabControlSystem,tabEditInfo
Support Phone => lblSupportPh,lstItemSystem,tabControlSystem,tabEditInfo
Support URL => lblSupportUrl,lstItemSystem,tabControlSystem,tabEditInfo
Disable Windows Installer service => chkDisableWinInstaller,lstItemSystem,tabControlSystem,tabWinInstaller
Always install with elevated privileges => chkElevatedInstall,lstItemSystem,tabControlSystem,tabWinInstaller
Turn off creation of System Restore points when installing => chkDisableSysRestoreInstall,lstItemSystem,tabControlSystem,tabWinInstaller
Owner Name => lblOwnerName,lstItemSystem,tabControlSystem,tabReg
Company Name => lblCompanyName,lstItemSystem,tabControlSystem,tabReg
Product ID => lblProductId,lstItemSystem,tabControlSystem,tabReg
Specify the image that will be displayed in Computer Property => lblImgCompProp,lstItemSystem,tabControlSystem,tabLogo
Don't do not search Windows when I click a shortcut whose program no longer exists => chkPreventStaleShortcutSearch,lstItemSystem,tabControlSystem,tabSearch
Stop Windows from searching disk to resolve a shortcut => chkPreventStateShortcutDiskSearch,lstItemSystem,tabControlSystem,tabSearch
Prevent Windows from using tracking feature of NTFS file system to resolve a shortcut => chkPreventUseOfNtfsTrack,lstItemSystem,tabControlSystem,tabSearch
Enable Windows Animation => chkWindowAnim,lstItemDisplay,tabControlDisplay,tabDisplaySettings
Show Windows content while dragging => chkShowWindowDrag,lstItemDisplay,tabControlDisplay,tabDisplaySettings
Show Windows version on the Desktop In white text => chkWindowVersion,lstItemDisplay,tabControlDisplay,tabDisplaySettings
Windows Border Width => lblWinBorderWidth,lstItemDisplay,tabControlDisplay,tabDisplaySettings
Horizontal Spacing Between Desktop => lblHorzSpace,lstItemDisplay,tabControlDisplay,tabDisplaySettings
Vertical Spacing Between Desktop Icons => lblVertSpace,lstItemDisplay,tabControlDisplay,tabDisplaySettings
Show hand icon over shared resources => chkHandIcon,lstItemDisplay,tabControlDisplay,tabDisplayExplorer
Display files using old style file sorting algorithm => chkOldStyleFileSort,lstItemDisplay,tabControlDisplay,tabDisplayExplorer
Show hide shortcut short cut arrow => txtShortcutArrowHeading,lstItemDisplay,tabControlDisplay,tabShortcutArrow
Wrap icon title behaviour => lblWrapIconTitle,lstItemDisplay,tabControlDisplay,tabIconTitle
Split long lines names into several small lines => rbtnWrapText,lstItemDisplay,tabControlDisplay,tabIconTitle
Show only one line and truncate it when too long => rbtnTruncateText,lstItemDisplay,tabControlDisplay,tabIconTitle
Specify the color for Selection rectangle used for selecting files folders in Windows Explorer => lblSelRect,lstItemDisplay,tabControlDisplay,tabSelectionColor
Icons shown in a single row of ALT + Tab switcher => lblAltTabCols,lstItemDisplay,tabControlDisplay,tabAltTab
Number of rows shown in ALT + Tab switcher => lblAltTabRows,lstItemDisplay,tabControlDisplay,tabAltTab
Add Copy to Folder to Right Click menu of every file and folder => chkCopyToFolder,lstItemRightClick,tabControlRightClick,tabGeneral
Add Move to Folder to Right Click menu of every file and folder => chkMoveToFolder,lstItemRightClick,tabControlRightClick,tabGeneral
Add Send to Folder to Right Click menu of every file and folder => chkSendTo,lstItemRightClick,tabControlRightClick,tabGeneral
Add Encrypt and Decrypt to Right Click menu of every file and folder => chkEncryptAndDecrypt,lstItemRightClick,tabControlRightClick,tabGeneral
Add Open with Notepad to Right Click menu for all files => chkOpenWithNotepad,lstItemRightClick,tabControlRightClick,tabGeneral
Add Control Panel to the Desktop Right Click Menu => chkControlPanelInDesktopMenu,lstItemRightClick,tabControlRightClick,tabGeneral
Make Open Command Prompt here always display for folders and drives => chkOpenCmdPrompt,lstItemRightClick,tabControlRightClick,tabGeneral
Add Defragment to the Right Click menu of drives => chkAddDefragInMenu,lstItemRightClick,tabControlRightClick,tabGeneral
Add shortcut to Right Click => tabAddItems,lstItemRightClick,tabControlRightClick,tabAddItems
Add to Send To Menu => tabSendTo,lstItemRightClick,tabControlRightClick,tabSendTo
Set up God Mode => lblSetupGodMode,lstItemPlaces,tabControlPlaces,tabGodMode
Customize Open With menu shown in Right Click Menu => lblOpenWith,lstItemPlaces,tabControlPlaces,tabOpenWith
Power Button action on Start Menu => lblPowerBtnAction,lstItemPlaces,tabControlPlaces,tabPowerBtn
Default app for file with no extension => lblNoExt,lstItemPlaces,tabControlPlaces,tabDefaultOpening
Manage programs that are executed when Windows starts and also Add or Remove programs from startup manager => lblStartupMgr,lstItemPlaces,tabControlPlaces,tabStartupMgr
Schedule Shutdown => tabScheduleShutdwn,lstItemTasks,tabControlTasks,tabScheduleShutdwn
Special hiding special hide => tabSpecialHiding,lstItemTasks,tabControlTasks,tabSpecialHiding
Use this option to hide files folders with System Privileges => lblHideSysPrivileges,lstItemTasks,tabControlTasks,tabSpecialHiding
Use this option to Un hide unhide files folders with System Privileges => lblUnhideSysPrivileges,lstItemTasks,tabControlTasks,tabSpecialHiding
Create Special Folders CON => lblSpecialFolders,lstItemTasks,tabControlTasks,tabSpecialFolderNames
Create large file of size => txtCreateFile,lstItemTasks,tabControlTasks,tabCreateFile
Use Autoplay for all devices => rbtnEnableAutoPlay,lstItemFeatures,tabControlFeatures,tabAutoplay
Turn off Autoplay for CD ROM and removable devices => rbtnEnableCdUsbAutoPlay,lstItemFeatures,tabControlFeatures,tabAutoplay
Turn off Autoplay for all devices => rbtnDisableAutoPlay,lstItemFeatures,tabControlFeatures,tabAutoplay
Configure Autoplay via Group Policy Editor => btnAutoPlayViaGP,lstItemFeatures,tabControlFeatures,tabAutoplay
Windows Update => tabWinUpdate,lstItemFeatures,tabControlFeatures,tabWinUpdate
Prevent Windows Update from forcibly rebooting Windows => chkUpdateReboot,lstItemFeatures,tabControlFeatures,tabWinUpdate
Give me recommended updates the same way I receive important updates => chkRecommenedUpdates,lstItemFeatures,tabControlFeatures,tabWinUpdate
Allow all users to install updates to this computer => chkAllowAllInstallUpdate,lstItemFeatures,tabControlFeatures,tabWinUpdate
Show detailed notifications when new Microsoft software is available => chkNotifyNewMSSw,lstItemFeatures,tabControlFeatures,tabWinUpdate
Administrator Account => tabAdminAccount,lstItemFeatures,tabControlFeatures,tabAdminAccount
Use Windows built in DVD Burner Disable builtin burner => chkWinDvdBurner,lstItemFeatures,tabControlFeatures,tabWinDvdBurner
Turn off System Beeps => chkSystemBeep,lstItemFeatures,tabControlFeatures,tabSysBeeps
Automatic Login Auto => tabAutoLogin,lstItemLogon,tabControlLogon,tabAutoLogin
Username => lblAutoLoginUserName,lstItemLogon,tabControlLogon,tabAutoLogin
Password => lblAutoLoginPasswd,lstItemLogon,tabControlLogon,tabAutoLogin
Domain Name => lblDomainName,lstItemLogon,tabControlLogon,tabAutoLogin
Prevent stopping automatic logon by pressing shift key => chkPreventShiftPress,lstItemLogon,tabControlLogon,tabAutoLogin
Logon automatically after Logoff => chkAutoLogonAfterLogoff,lstItemLogon,tabControlLogon,tabAutoLogin
Play a sound when Windows starts up => chkLoginSound,lstItemLogon,tabControlLogon,tabStartupSound
Make screensaver password protected and prevent users from changing this setting screensaver lock screen saver lock => chkScreenSaverLock,lstItemLogon,tabControlLogon,tabScreenLk
Show a message before user logs on => chkEnableLoginMsg,lstItemLogon,tabControlLogon,tabLoginMsg
Require users to press Ctrl Alt Delete before logon => chkRequireCtrlAltDlt,lstItemLogon,tabControlLogon,tabLoginMisc
Show classic login screen => chkRestrictLastLoginUser,lstItemLogon,tabControlLogon,tabLoginMisc
Show shutdown button on login screen => chkShowShutdownBtn,lstItemLogon,tabControlLogon,tabLoginMisc
Don't do not allow any changes to Lock Screen image => chkLockScreenImg,lstItemLogon,tabControlLogon,tabLockScreen
Skip lock screen and directly open Sign in screen when I start Windows => chkLockScreen,lstItemLogon,tabControlLogon,tabLockScreen
Disable File menu in Explorer => chkHideFileMenu,lstItemRestrictions,tabControlRestrictions,tabExplorerRestrictions
Disable Folder options => chkHideFolderOpt,lstItemRestrictions,tabControlRestrictions,tabExplorerRestrictions
Disable Right Click => chkRightClick,lstItemRestrictions,tabControlRestrictions,tabExplorerRestrictions
Disable Right Click for Taskbar and Start Menu => chkTasbarAndStartMenuRightClick,lstItemRestrictions,tabControlRestrictions,tabExplorerRestrictions
Hide Appearance option under Display Menu => chkHideAppearanceOpt,lstItemRestrictions,tabControlRestrictions,tabExplorerRestrictions
Disable changes to screensaver => chkHideChangeScreensaver,lstItemRestrictions,tabControlRestrictions,tabExplorerRestrictions
Disable thumbnail caching => chkHideThumbNailCache,lstItemRestrictions,tabControlRestrictions,tabExplorerRestrictions
Disable Flip 3D for the current user => chkHide3DFlip,lstItemRestrictions,tabControlRestrictions,tabExplorerRestrictions
Disable all Windows Win Keyboard shortcuts Hotkeys => chkNoWinKeys,lstItemRestrictions,tabControlRestrictions,tabExplorerRestrictions
Disable Show Password Button in Windows and Internet Explorer => chkDisableShowPasswd,lstItemRestrictions,tabControlRestrictions,tabExplorerRestrictions
Disable Shutdown option => chkHideShutDownOpt,lstItemRestrictions,tabControlRestrictions,tabStartMenuRestrictions
Hide recent documents => chkHideRecentDocs,lstItemRestrictions,tabControlRestrictions,tabStartMenuRestrictions
Disable changes to start menu => chkHideChangesStartMenu,lstItemRestrictions,tabControlRestrictions,tabStartMenuRestrictions
Disable logoff log off option => chkHideLogOff,lstItemRestrictions,tabControlRestrictions,tabStartMenuRestrictions
Hide Control Panel => chkHideControlPanel,lstItemRestrictions,tabControlRestrictions,tabStartMenuRestrictions
Disable deletion of printers => chkDisableDeletionPrinters,lstItemRestrictions,tabControlRestrictions,tabSystemRestrictions
Disable addition of new printers => chkDisableAddNewPrinter,lstItemRestrictions,tabControlRestrictions,tabSystemRestrictions
Disable Windows update => chkDisableWindUpdate,lstItemRestrictions,tabControlRestrictions,tabSystemRestrictions
Disable changes to Virtual Memory => chkDisableChangeToVirtualMem,lstItemRestrictions,tabControlRestrictions,tabSystemRestrictions
Disable Windows Registry editing tools => chkDisableWindowRegEditTool,lstItemRestrictions,tabControlRestrictions,tabSystemRestrictions
Disable Task Manager => chkDisableTaskManager,lstItemRestrictions,tabControlRestrictions,tabSystemRestrictions
Disable administrative shares => chkDisableAdminShares,lstItemRestrictions,tabControlRestrictions,tabSystemRestrictions
Disable Taskbar animations => chkTaskBarAnim,lstItemRestrictions,tabControlRestrictions,tabTaskbarRestrictions
Show small icons on TaskBar => chkShowIconsTaskBar,lstItemRestrictions,tabControlRestrictions,tabTaskbarRestrictions
Disable Taskbar Tooltips tool tips => chkTaskBarNoTooltip,lstItemRestrictions,tabControlRestrictions,tabTaskbarRestrictions
Disable Group Policy update during startup => chkDisableGroupPolicy,lstItemMaintenance,tabControlMaintenance,tabMemory
Unload unused DLLs after an application is closed => chkUnloadUnsedDLL,lstItemMaintenance,tabControlMaintenance,tabMemory
Do not Don't show error reporting dialog when an app crashes => chkHideErrReporting,lstItemMaintenance,tabControlMaintenance,tabError
Type of report that should be send to Microsoft when an error occurs => lblErrReportType,lstItemMaintenance,tabControlMaintenance,tabError
Enable boot defragmentation => chkEnableBootDefrag,lstItemMaintenance,tabControlMaintenance,tabStartupSettings
Disable creation of last known good configuration => chkDisableLKGC,lstItemMaintenance,tabControlMaintenance,tabStartupSettings
Default action to perform when Windows crashes => lblWinCrashAction,lstItemMaintenance,tabControlMaintenance,tabAutoReboot
Record event in system log => chkRecordCrashEvent,lstItemMaintenance,tabControlMaintenance,tabAutoReboot
drive letter display => tabDriveLetterDisplay,lstItemExplorer,tabControlExplorer,tabDriveLetterDisplay
advanced => tabAdvanced,lstItemExplorer,tabControlExplorer,tabAdvanced
properties => tabProperties,lstItemExplorer,tabControlExplorer,tabProperties
libraries library => tabLibrary,lstItemExplorer,tabControlExplorer,tabLibrary
start screen => tabStartScreen,lstItemExplorer,tabControlExplorer,tabStartScreen
navigation => tabNavigation,lstItemExplorer,tabControlExplorer,tabNavigation
etc etcetra => tabEtc,lstItemExplorer,tabControlExplorer,tabEtc
shutdown configuration configure => tabShutdwnConfig,lstItemSystem,tabControlSystem,tabShutdwnConfig
edit information info => tabEditInfo,lstItemSystem,tabControlSystem,tabEditInfo
windows installer install => tabWinInstaller,lstItemSystem,tabControlSystem,tabWinInstaller
registration register => tabReg,lstItemSystem,tabControlSystem,tabReg
logo => tabLogo,lstItemSystem,tabControlSystem,tabLogo
display settings => tabDisplaySettings,lstItemDisplay,tabControlDisplay,tabDisplaySettings
explorer => tabDisplayExplorer,lstItemDisplay,tabControlDisplay,tabDisplayExplorer
icon title => tabIconTitle,lstItemDisplay,tabControlDisplay,tabIconTitle
selection color => tabSelectionColor,lstItemDisplay,tabControlDisplay,tabSelectionColor
alt tab => tabAltTab,lstItemDisplay,tabControlDisplay,tabAltTab
general => tabGeneral,lstItemRightClick,tabControlRightClick,tabGeneral
add items => tabAddItems,lstItemRightClick,tabControlRightClick,tabAddItems
default opening => tabDefaultOpening,lstItemPlaces,tabControlPlaces,tabDefaultOpening
startup manager start => tabStartupMgr,lstItemPlaces,tabControlPlaces,tabStartupMgr
logon login message => tabLoginMsg,lstItemLogon,tabControlLogon,tabLoginMsg
miscellaneous => tabLoginMisc,lstItemLogon,tabControlLogon,tabLoginMisc
memory => tabMemory,lstItemMaintenance,tabControlMaintenance,tabMemory
auto automatic reboot => tabAutoReboot,lstItemMaintenance,tabControlMaintenance,tabAutoReboot
Group Policy Editor => lnkGpedit,lstItemUtilities,tabControlUtilities,tabUtilSystem
Component Services => lnkCmpServices,lstItemUtilities,tabControlUtilities,tabUtilSystem
Device Manager => lnkDevMgr,lstItemUtilities,tabControlUtilities,tabUtilSystem
Event Viewer => lnkEventVwr,lstItemUtilities,tabControlUtilities,tabUtilSystem
Local Users and Group => lnkLuserMsg,lstItemUtilities,tabControlUtilities,tabUtilSystem
Windows Services => lnkWinServices,lstItemUtilities,tabControlUtilities,tabUtilSystem
System Configuration Utility => lnkSysConfigUtil,lstItemUtilities,tabControlUtilities,tabUtilSystem
Remote Shutdown Dialog => lnkRemoteShutdown,lstItemUtilities,tabControlUtilities,tabUtilSystem
Windows System Security Tool => lnkWinSecTool,lstItemUtilities,tabControlUtilities,tabUtilSystem
Computer Management => lnkCompMgmt,lstItemUtilities,tabControlUtilities,tabUtilSystem
Direct X Troubleshooter => lnkDxDiag,lstItemUtilities,tabControlUtilities,tabUtilSystem
Local Security Settings => lnkLocalSecSetting,lstItemUtilities,tabControlUtilities,tabUtilSystem
Windows Registry Editor => lnkRegedit,lstItemUtilities,tabControlUtilities,tabUtilSystem
System Configuration Editor => lnkSysConfigEdt,lstItemUtilities,tabControlUtilities,tabUtilSystem
System Information => lnkSysInfo,lstItemUtilities,tabControlUtilities,tabUtilSystem
Old Command Prompt command.com => lnkCmdCom,lstItemUtilities,tabControlUtilities,tabUtilSystem
Start Check Disk Utility => lnkChkDsk,lstItemUtilities,tabControlUtilities,tabUtilDisk
Disk Defragment => lnkDskDefrg,lstItemUtilities,tabControlUtilities,tabUtilDisk
Disk Partition => lnkDskPart,lstItemUtilities,tabControlUtilities,tabUtilDisk
Advanced Disk Cleanup => lnkAdvDskClean,lstItemUtilities,tabControlUtilities,tabUtilDisk
Disk Cleanup => lnkDskClean,lstItemUtilities,tabControlUtilities,tabUtilDisk
Disk Management => lnkDskMgmt,lstItemUtilities,tabControlUtilities,tabUtilDisk
Create Shared Folder => lnkCrtSharedFldr,lstItemUtilities,tabControlUtilities,tabUtilNetwork
Remote Desktop => lnkRmtDesktp,lstItemUtilities,tabControlUtilities,tabUtilNetwork
Phone Dialer => lnkPhnDialer,lstItemUtilities,tabControlUtilities,tabUtilNetwork
Windows Easy Transfer => lnkWinEsyTrnsfr,lstItemUtilities,tabControlUtilities,tabUtilNetwork
Shared Folder => lnkShrdFldr,lstItemUtilities,tabControlUtilities,tabUtilNetwork
Remote Address Phonebook => lnkRmtAccessPhnBuk,lstItemUtilities,tabControlUtilities,tabUtilNetwork
Network Connections => lnkNtwrkConns,lstItemUtilities,tabControlUtilities,tabUtilNetwork
Character Map => lnkCharMap,lstItemUtilities,tabControlUtilities,tabUtilMisc
Driver Verifier Utility => lnkDrvrVerifier,lstItemUtilities,tabControlUtilities,tabUtilMisc
Installer Creator Wizard => lnkInstallerCrtr,lstItemUtilities,tabControlUtilities,tabUtilMisc
Windows Address Book => lnkWab,lstItemUtilities,tabControlUtilities,tabUtilMisc
Private Character Editor => lnkPrvtCharEdtr,lstItemUtilities,tabControlUtilities,tabUtilMisc
File Signature Verification Toolkit => lnkFlSigVerfr,lstItemUtilities,tabControlUtilities,tabUtilMisc
Regional Settings => lnkRegSettings,lstItemUtilities,tabControlUtilities,tabUtilMisc
Address Book Import Utility => lnkDrtX,lstItemUtilities,tabControlUtilities,tabUtilMisc
Advanced User Accounts Control Panel => lnkAdvUserCp,lstItemUtilities,tabControlUtilities,tabUtilMisc